7 20
*I *  *********  **
*  *              *
*  ****************
*  *  **          *
*  *  **      *   *
*     *F      *   *
****  *********  **

