15 15
** ******* ****
I  **         *
** ****** * ***
*         *   *
* * ******* ***
  * ***        
*** *** *******
*    *** **  **
* ***** *** ***
  **           
* ** ****** ***
*            **
** ******* * **
**    ***  * F*
** ****** *****
